2500 2500
1350 650 1 1350 650 1 100 100 100 1
1350 750 1 1350 750 1 100 100 100 1
1350 850 1 1350 850 1 100 100 100 1
1350 950 1 1350 950 1 100 100 100 1
1350 1050 1 1350 1050 1 100 100 100 1
1450 1050 1 1450 1050 1 100 100 100 1
1450 1150 1 1450 1150 1 100 100 100 1
1450 1250 1 1450 1250 1 100 100 100 1
1550 1250 1 1550 1250 1 100 100 100 1
1550 1350 1 1550 1350 1 100 100 100 1
1650 1450 1 1650 1450 1 100 100 100 1
1750 1450 1 1750 1450 1 100 100 100 1
1750 1350 1 1750 1350 1 100 100 100 1
1850 1250 1 1850 1250 1 100 100 100 1
1850 1150 1 1850 1150 1 100 100 100 1
1950 1050 1 1950 1050 1 100 100 100 1
1950 950 1 1950 950 1 100 100 100 1
1950 850 1 1950 850 1 100 100 100 1
1950 750 1 1950 750 1 100 100 100 1
1950 650 1 1950 650 1 100 100 100 1
1850 650 1 1850 650 1 100 100 100 1
1850 550 1 1850 550 1 100 100 100 1
1850 450 1 1850 450 1 100 100 100 1
1750 450 1 1750 450 1 100 100 100 1
1750 350 1 1750 350 1 100 100 100 1
1650 350 1 1650 350 1 100 100 100 1
1650 250 1 1650 250 1 100 100 100 1
1550 250 1 1550 250 1 100 100 100 1
1450 250 1 1450 250 1 100 100 100 1
1350 250 1 1350 250 1 100 100 100 1
1250 250 1 1250 250 1 100 100 100 1
1250 350 1 1250 350 1 100 100 100 1
1250 450 1 1250 450 1 100 100 100 1
1150 450 1 1150 450 1 100 100 100 1
1150 550 1 1150 550 1 100 100 100 1
1050 650 1 1050 650 1 100 100 100 1
1050 750 1 1050 750 1 100 100 100 1
1050 850 1 1050 850 1 100 100 100 1
1050 950 1 1050 950 1 100 100 100 1
1050 1150 1 1050 1150 1 100 100 100 1
1050 1250 1 1050 1250 1 100 100 100 1
1050 1350 1 1050 1350 1 100 100 100 1
1050 1450 1 1050 1450 1 100 100 100 1
1150 1650 1 1150 1650 1 100 100 100 1
1150 1750 1 1150 1750 1 100 100 100 1
1150 1850 1 1150 1850 1 100 100 100 1
1250 1950 1 1250 1950 1 100 100 100 1
1350 2050 1 1350 2050 1 100 100 100 1
1350 2150 1 1350 2150 1 100 100 100 1
1450 2150 1 1450 2150 1 100 100 100 1
1550 2150 1 1550 2150 1 100 100 100 1
1650 2250 1 1650 2250 1 100 100 100 1
1750 2350 1 1750 2350 1 100 100 100 1
1850 2350 1 1850 2350 1 100 100 100 1
1950 2350 1 1950 2350 1 100 100 100 1
2050 2350 1 2050 2350 1 100 100 100 1
2050 2250 1 2050 2250 1 100 100 100 1
2150 2150 1 2150 2150 1 100 100 100 1
2150 2050 1 2150 2050 1 100 100 100 1
2150 1950 1 2150 1950 1 100 100 100 1
2150 1850 1 2150 1850 1 100 100 100 1
2150 1750 1 2150 1750 1 100 100 100 1
2150 1650 1 2150 1650 1 100 100 100 1
2150 1550 1 2150 1550 1 100 100 100 1
2250 1450 1 2250 1450 1 100 100 100 1
2250 1350 1 2250 1350 1 100 100 100 1
2250 1250 1 2250 1250 1 100 100 100 1
2250 1150 1 2250 1150 1 100 100 100 1
2150 1150 1 2150 1150 1 100 100 100 1
2150 1050 1 2150 1050 1 100 100 100 1
2150 950 1 2150 950 1 100 100 100 1
2150 850 1 2150 850 1 100 100 100 1
2150 750 1 2150 750 1 100 100 100 1
2150 650 1 2150 650 1 100 100 100 1
2050 550 1 2050 550 1 100 100 100 1
2050 450 1 2050 450 1 100 100 100 1
2050 350 1 2050 350 1 100 100 100 1
1950 350 1 1950 350 1 100 100 100 1
1950 250 1 1950 250 1 100 100 100 1
1850 150 1 1850 150 1 100 100 100 1
1850 50 1 1850 50 1 100 100 100 1
1750 50 1 1750 50 1 100 100 100 1
1350 50 1 1350 50 1 100 100 100 1
1250 50 1 1250 50 1 100 100 100 1
1150 50 1 1150 50 1 100 100 100 1
1050 150 1 1050 150 1 100 100 100 1
1050 250 1 1050 250 1 100 100 100 1
950 250 1 950 250 1 100 100 100 1
950 350 1 950 350 1 100 100 100 1
850 350 1 850 350 1 100 100 100 1
850 450 1 850 450 1 100 100 100 1
850 550 1 850 550 1 100 100 100 1
850 650 1 850 650 1 100 100 100 1
750 750 1 750 750 1 100 100 100 1
750 850 1 750 850 1 100 100 100 1
750 950 1 750 950 1 100 100 100 1
750 1050 1 750 1050 1 100 100 100 1
750 1150 1 750 1150 1 100 100 100 1
750 1250 1 750 1250 1 100 100 100 1
650 1250 1 650 1250 1 100 100 100 1
750 1350 1 750 1350 1 100 100 100 1
750 1450 1 750 1450 1 100 100 100 1
750 1550 1 750 1550 1 100 100 100 1
750 1650 1 750 1650 1 100 100 100 1
750 1750 1 750 1750 1 100 100 100 1
750 1850 1 750 1850 1 100 100 100 1
750 1950 1 750 1950 1 100 100 100 1
750 2050 1 750 2050 1 100 100 100 1
