2500 2500
950 950 1 950 950 1 100 100 100 0
1050 950 1 1050 950 1 100 100 100 1
1150 950 1 1150 950 1 100 100 100 1
1150 850 1 1150 850 1 100 100 100 1
1250 850 1 1250 850 1 100 100 100 1
1350 850 1 1350 850 1 100 100 100 1
1450 850 1 1450 850 1 100 100 100 2
1550 850 1 1550 850 1 100 100 100 2
1550 950 1 1550 950 1 100 100 100 2
1550 1050 1 1550 1050 1 100 100 100 2
1550 1150 1 1550 1150 1 100 100 100 2
1550 1250 1 1550 1250 1 100 100 100 2
1550 1350 1 1550 1350 1 100 100 100 2
1550 1450 1 1550 1450 1 100 100 100 2
1550 1550 1 1550 1550 1 100 100 100 2
1550 1650 1 1550 1650 1 100 100 100 2
1550 1750 1 1550 1750 1 100 100 100 2
1550 1850 1 1550 1850 1 100 100 100 2
850 950 1 850 950 1 100 100 100 1
850 1050 1 850 1050 1 100 100 100 1
850 1150 1 850 1150 1 100 100 100 1
850 1250 1 850 1250 1 100 100 100 1
850 1350 1 850 1350 1 100 100 100 1
850 1450 1 850 1450 1 100 100 100 1
850 1550 1 850 1550 1 100 100 100 1
850 1650 1 850 1650 1 100 100 100 1
850 1750 1 850 1750 1 100 100 100 1
850 1850 1 850 1850 1 100 100 100 1
850 1950 1 850 1950 1 100 100 100 1
950 1950 1 950 1950 1 100 100 100 1
1050 1950 1 1050 1950 1 100 100 100 1
1150 1950 1 1150 1950 1 100 100 100 1
1150 2050 1 1150 2050 1 100 100 100 1
1250 2050 1 1250 2050 1 100 100 100 1
1350 2050 1 1350 2050 1 100 100 100 1
1350 1950 1 1350 1950 1 100 100 100 1
1450 1950 1 1450 1950 1 100 100 100 1
1450 2050 1 1450 2050 1 100 100 100 1
1650 2050 1 1650 2050 1 100 100 100 0
1650 1950 1 1650 1950 1 100 100 100 0
1650 1850 1 1650 1850 1 100 100 100 0
1650 1750 1 1650 1750 1 100 100 100 0
1650 1650 1 1650 1650 1 100 100 100 0
1650 1550 1 1650 1550 1 100 100 100 0
1650 1450 1 1650 1450 1 100 100 100 0
1650 1350 1 1650 1350 1 100 100 100 0
1650 1250 1 1650 1250 1 100 100 100 0
1650 1150 1 1650 1150 1 100 100 100 0
1650 1050 1 1650 1050 1 100 100 100 0
1650 950 1 1650 950 1 100 100 100 0
1650 850 1 1650 850 1 100 100 100 0
1650 750 1 1650 750 1 100 100 100 0
1550 750 1 1550 750 1 100 100 100 0
1450 750 1 1450 750 1 100 100 100 0
1350 750 1 1350 750 1 100 100 100 0
1250 750 1 1250 750 1 100 100 100 0
1150 750 1 1150 750 1 100 100 100 0
1050 750 1 1050 750 1 100 100 100 0
950 750 1 950 750 1 100 100 100 0
850 750 1 850 750 1 100 100 100 0
750 750 1 750 750 1 100 100 100 0
650 750 1 650 750 1 100 100 100 0
650 850 1 650 850 1 100 100 100 0
650 950 1 650 950 1 100 100 100 0
650 1050 1 650 1050 1 100 100 100 0
650 1150 1 650 1150 1 100 100 100 0
650 1250 1 650 1250 1 100 100 100 0
650 1350 1 650 1350 1 100 100 100 0
650 1450 1 650 1450 1 100 100 100 0
650 1550 1 650 1550 1 100 100 100 0
650 1650 1 650 1650 1 100 100 100 0
650 1750 1 650 1750 1 100 100 100 0
650 1850 1 650 1850 1 100 100 100 0
650 1950 1 650 1950 1 100 100 100 0
650 2050 1 650 2050 1 100 100 100 0
650 2150 1 650 2150 1 100 100 100 0
650 2250 1 650 2250 1 100 100 100 0
750 2250 1 750 2250 1 100 100 100 0
850 2250 1 850 2250 1 100 100 100 0
950 2250 1 950 2250 1 100 100 100 0
1050 2250 1 1050 2250 1 100 100 100 0
1150 2250 1 1150 2250 1 100 100 100 0
1250 2250 1 1250 2250 1 100 100 100 0
1350 2250 1 1350 2250 1 100 100 100 0
1450 2250 1 1450 2250 1 100 100 100 0
1550 2250 1 1550 2250 1 100 100 100 0
1650 2250 1 1650 2250 1 100 100 100 0
1650 2150 1 1650 2150 1 100 100 100 0
