2500 2500
108
750 450 1 750 450 1 100 100 100 0
850 450 1 850 450 1 100 100 100 0
850 550 1 850 550 1 100 100 100 0
950 550 1 950 550 1 100 100 100 0
950 650 1 950 650 1 100 100 100 0
950 750 1 950 750 1 100 100 100 0
950 850 1 950 850 1 100 100 100 0
1050 850 1 1050 850 1 100 100 100 0
1050 950 1 1050 950 1 100 100 100 0
1050 1050 1 1050 1050 1 100 100 100 0
1150 1150 1 1150 1150 1 100 100 100 0
1150 1250 1 1150 1250 1 100 100 100 0
1250 1350 1 1250 1350 1 100 100 100 0
1350 1350 1 1350 1350 1 100 100 100 0
1450 1450 1 1450 1450 1 100 100 100 0
1550 1450 1 1550 1450 1 100 100 100 0
1650 1450 1 1650 1450 1 100 100 100 0
1650 1350 1 1650 1350 1 100 100 100 0
1750 1350 1 1750 1350 1 100 100 100 0
1850 1250 1 1850 1250 1 100 100 100 0
1850 1150 1 1850 1150 1 100 100 100 0
1850 1050 1 1850 1050 1 100 100 100 0
1850 950 1 1850 950 1 100 100 100 0
1850 850 1 1850 850 1 100 100 100 0
1850 750 1 1850 750 1 100 100 100 0
1850 650 1 1850 650 1 100 100 100 0
1850 550 1 1850 550 1 100 100 100 0
1750 550 1 1750 550 1 100 100 100 0
1750 450 1 1750 450 1 100 100 100 0
1650 350 1 1650 350 1 100 100 100 0
1550 250 1 1550 250 1 100 100 100 0
1550 150 1 1550 150 1 100 100 100 0
1450 150 1 1450 150 1 100 100 100 0
1350 150 1 1350 150 1 100 100 100 0
1250 150 1 1250 150 1 100 100 100 0
1150 50 1 1150 50 1 100 100 100 0
1050 50 1 1050 50 1 100 100 100 0
950 50 1 950 50 1 100 100 100 0
850 50 1 850 50 1 100 100 100 0
750 50 1 750 50 1 100 100 100 0
750 150 1 750 150 1 100 100 100 0
650 150 1 650 150 1 100 100 100 0
650 250 1 650 250 1 100 100 100 0
650 350 1 650 350 1 100 100 100 0
650 450 1 650 450 1 100 100 100 0
650 550 1 650 550 1 100 100 100 0
650 650 1 650 650 1 100 100 100 0
650 750 1 650 750 1 100 100 100 0
650 850 1 650 850 1 100 100 100 0
650 950 1 650 950 1 100 100 100 0
650 1050 1 650 1050 1 100 100 100 0
650 1150 1 650 1150 1 100 100 100 0
550 1150 1 550 1150 1 100 100 100 0
550 1250 1 550 1250 1 100 100 100 0
550 1350 1 550 1350 1 100 100 100 0
550 1450 1 550 1450 1 100 100 100 0
550 1550 1 550 1550 1 100 100 100 0
650 1650 1 650 1650 1 100 100 100 0
650 1750 1 650 1750 1 100 100 100 0
650 1850 1 650 1850 1 100 100 100 0
750 1850 1 750 1850 1 100 100 100 0
750 1950 1 750 1950 1 100 100 100 0
850 1950 1 850 1950 1 100 100 100 0
950 1950 1 950 1950 1 100 100 100 0
1050 1950 1 1050 1950 1 100 100 100 0
1150 1950 1 1150 1950 1 100 100 100 0
1250 1950 1 1250 1950 1 100 100 100 0
1350 1950 1 1350 1950 1 100 100 100 0
1350 2050 1 1350 2050 1 100 100 100 0
1450 2050 1 1450 2050 1 100 100 100 0
1550 2050 1 1550 2050 1 100 100 100 0
1650 2050 1 1650 2050 1 100 100 100 0
1750 2050 1 1750 2050 1 100 100 100 0
1850 2050 1 1850 2050 1 100 100 100 0
1950 2050 1 1950 2050 1 100 100 100 0
2050 2050 1 2050 2050 1 100 100 100 0
2050 1950 1 2050 1950 1 100 100 100 0
2150 1950 1 2150 1950 1 100 100 100 0
2150 1850 1 2150 1850 1 100 100 100 0
2250 1750 1 2250 1750 1 100 100 100 0
2250 1650 1 2250 1650 1 100 100 100 0
2250 1550 1 2250 1550 1 100 100 100 0
2250 1450 1 2250 1450 1 100 100 100 0
2250 1350 1 2250 1350 1 100 100 100 0
2250 1250 1 2250 1250 1 100 100 100 0
2250 1150 1 2250 1150 1 100 100 100 0
2350 1050 1 2350 1050 1 100 100 100 0
2350 950 1 2350 950 1 100 100 100 0
2350 850 1 2350 850 1 100 100 100 0
2350 750 1 2350 750 1 100 100 100 0
2350 650 1 2350 650 1 100 100 100 0
2250 650 1 2250 650 1 100 100 100 0
2250 550 1 2250 550 1 100 100 100 0
2250 450 1 2250 450 1 100 100 100 0
2250 350 1 2250 350 1 100 100 100 0
2150 350 1 2150 350 1 100 100 100 0
2150 250 1 2150 250 1 100 100 100 0
2050 250 1 2050 250 1 100 100 100 0
2050 150 1 2050 150 1 100 100 100 0
1950 150 1 1950 150 1 100 100 100 0
1850 150 1 1850 150 1 100 100 100 0
1850 50 1 1850 50 1 100 100 100 0
1750 50 1 1750 50 1 100 100 100 0
1650 50 1 1650 50 1 100 100 100 0
1550 50 1 1550 50 1 100 100 100 0
1450 50 1 1450 50 1 100 100 100 0
1350 50 1 1350 50 1 100 100 100 0
1250 50 1 1250 50 1 100 100 100 0
