1690 900
85
50 50 1 50 50 1 100 100 100 0
50 150 1 50 150 1 100 100 100 0
150 150 1 150 150 1 100 100 100 0
150 250 1 150 250 1 100 100 100 0
150 350 1 150 350 1 100 100 100 0
150 450 1 150 450 1 100 100 100 0
150 550 1 150 550 1 100 100 100 0
50 650 1 50 650 1 100 100 100 0
50 750 1 50 750 1 100 100 100 0
50 850 1 50 850 1 100 100 100 0
150 850 1 150 850 1 100 100 100 0
250 850 1 250 850 1 100 100 100 0
350 850 1 350 850 1 100 100 100 0
450 850 1 450 850 1 100 100 100 0
550 850 1 550 850 1 100 100 100 0
650 850 1 650 850 1 100 100 100 0
750 850 1 750 850 1 100 100 100 0
850 850 1 850 850 1 100 100 100 0
950 850 1 950 850 1 100 100 100 0
1050 850 1 1050 850 1 100 100 100 0
1150 850 1 1150 850 1 100 100 100 0
1250 850 1 1250 850 1 100 100 100 0
1350 850 1 1350 850 1 100 100 100 0
1450 850 1 1450 850 1 100 100 100 0
1550 850 1 1550 850 1 100 100 100 0
1650 850 1 1650 850 1 100 100 100 0
1650 750 1 1650 750 1 100 100 100 0
1650 650 1 1650 650 1 100 100 100 0
1650 550 1 1650 550 1 100 100 100 0
1650 450 1 1650 450 1 100 100 100 0
1650 350 1 1650 350 1 100 100 100 0
1650 250 1 1650 250 1 100 100 100 0
1650 150 1 1650 150 1 100 100 100 0
1650 50 1 1650 50 1 100 100 100 0
1550 50 1 1550 50 1 100 100 100 0
1450 50 1 1450 50 1 100 100 100 0
1350 50 1 1350 50 1 100 100 100 0
1250 50 1 1250 50 1 100 100 100 0
1150 50 1 1150 50 1 100 100 100 0
1050 50 1 1050 50 1 100 100 100 0
950 50 1 950 50 1 100 100 100 0
850 50 1 850 50 1 100 100 100 0
750 50 1 750 50 1 100 100 100 0
650 50 1 650 50 1 100 100 100 0
550 50 1 550 50 1 100 100 100 0
450 50 1 450 50 1 100 100 100 0
350 50 1 350 50 1 100 100 100 0
250 50 1 250 50 1 100 100 100 0
150 50 1 150 50 1 100 100 100 0
250 150 1 250 150 1 100 100 100 2
250 250 1 250 250 1 100 100 100 2
250 350 1 250 350 1 100 100 100 2
250 450 1 250 450 1 100 100 100 2
250 550 1 250 550 1 100 100 100 2
250 650 1 250 650 1 100 100 100 2
250 750 1 250 750 1 100 100 100 2
350 750 1 350 750 1 100 100 100 2
450 750 1 450 750 1 100 100 100 2
550 750 1 550 750 1 100 100 100 2
650 750 1 650 750 1 100 100 100 2
750 750 1 750 750 1 100 100 100 2
850 750 1 850 750 1 100 100 100 2
950 750 1 950 750 1 100 100 100 2
1050 750 1 1050 750 1 100 100 100 2
1150 750 1 1150 750 1 100 100 100 2
1250 750 1 1250 750 1 100 100 100 2
1350 750 1 1350 750 1 100 100 100 2
1450 750 1 1450 750 1 100 100 100 2
1450 650 1 1450 650 1 100 100 100 2
1450 550 1 1450 550 1 100 100 100 2
1450 450 1 1450 450 1 100 100 100 2
1450 350 1 1450 350 1 100 100 100 2
1450 250 1 1450 250 1 100 100 100 2
1450 150 1 1450 150 1 100 100 100 2
1350 150 1 1350 150 1 100 100 100 2
1250 150 1 1250 150 1 100 100 100 2
1150 150 1 1150 150 1 100 100 100 2
1050 150 1 1050 150 1 100 100 100 2
950 150 1 950 150 1 100 100 100 2
850 150 1 850 150 1 100 100 100 2
750 150 1 750 150 1 100 100 100 2
650 150 1 650 150 1 100 100 100 2
550 150 1 550 150 1 100 100 100 2
450 150 1 450 150 1 100 100 100 2
350 150 1 350 150 1 100 100 100 2
