2500 800
1353.13 352 -10 1303.13 302 -60 100 100 100 1
1453.13 448 -10 1403.13 398 -60 100 100 100 1
1553.13 550.667 -10 1503.13 500.667 -60 100 100 100 1
1646.88 650.667 -10 1596.88 600.667 -60 100 100 100 1
1753.13 752 -10 1703.13 702 -60 100 100 100 1
