2500 2500
750 1150 1 750 1150 1 100 100 100 0
850 1150 1 850 1150 1 100 100 100 0
850 1050 1 850 1050 1 100 100 100 0
950 1050 1 950 1050 1 100 100 100 0
750 350 1 750 350 1 100 100 100 1
850 350 1 850 350 1 100 100 100 1
850 450 1 850 450 1 100 100 100 1
950 450 1 950 450 1 100 100 100 1
1050 450 1 1050 450 1 100 100 100 1
1050 550 1 1050 550 1 100 100 100 1
1150 550 1 1150 550 1 100 100 100 1
1150 650 1 1150 650 1 100 100 100 1
1150 750 1 1150 750 1 100 100 100 1
1150 850 1 1150 850 1 100 100 100 1
1250 950 1 1250 950 1 100 100 100 1
1250 1050 1 1250 1050 1 100 100 100 1
1250 1150 1 1250 1150 1 100 100 100 1
1250 1250 1 1250 1250 1 100 100 100 1
250 950 1 250 950 1 100 100 100 0
250 1050 1 250 1050 1 100 100 100 0
250 1150 1 250 1150 1 100 100 100 0
250 1250 1 250 1250 1 100 100 100 0
350 1350 1 350 1350 1 100 100 100 0
350 1450 1 350 1450 1 100 100 100 0
350 1550 1 350 1550 1 100 100 100 0
350 1650 1 350 1650 1 100 100 100 0
450 1650 1 450 1650 1 100 100 100 0
450 1750 1 450 1750 1 100 100 100 0
450 1850 1 450 1850 1 100 100 100 0
550 1850 1 550 1850 1 100 100 100 0
550 1950 1 550 1950 1 100 100 100 0
650 1950 1 650 1950 1 100 100 100 0
750 1950 1 750 1950 1 100 100 100 0
850 1950 1 850 1950 1 100 100 100 0
950 1950 1 950 1950 1 100 100 100 0
1050 1950 1 1050 1950 1 100 100 100 0
650 750 1 650 750 1 100 100 100 2
650 850 1 650 850 1 100 100 100 2
650 950 1 650 950 1 100 100 100 2
650 1050 1 650 1050 1 100 100 100 2
650 1150 1 650 1150 1 100 100 100 2
650 1250 1 650 1250 1 100 100 100 2
650 1350 1 650 1350 1 100 100 100 2
650 1450 1 650 1450 1 100 100 100 2
650 1550 1 650 1550 1 100 100 100 2
750 1550 1 750 1550 1 100 100 100 2
750 1650 1 750 1650 1 100 100 100 2
850 1650 1 850 1650 1 100 100 100 2
950 1650 1 950 1650 1 100 100 100 2
1050 1650 1 1050 1650 1 100 100 100 2
1150 1650 1 1150 1650 1 100 100 100 2
1250 1650 1 1250 1650 1 100 100 100 2
1250 1550 1 1250 1550 1 100 100 100 2
1350 1550 1 1350 1550 1 100 100 100 2
1350 1650 1 1350 1650 1 100 100 100 2
1350 1750 1 1350 1750 1 100 100 100 2
1350 1850 1 1350 1850 1 100 100 100 2
1350 1950 1 1350 1950 1 100 100 100 2
1250 2050 1 1250 2050 1 100 100 100 2
1150 2150 1 1150 2150 1 100 100 100 2
1050 2150 1 1050 2150 1 100 100 100 2
950 2150 1 950 2150 1 100 100 100 2
850 2150 1 850 2150 1 100 100 100 2
750 2150 1 750 2150 1 100 100 100 2
750 2050 1 750 2050 1 100 100 100 2
650 2050 1 650 2050 1 100 100 100 2
650 1850 1 650 1850 1 100 100 100 2
650 1750 1 650 1750 1 100 100 100 2
650 1650 1 650 1650 1 100 100 100 2
550 2050 1 550 2050 1 100 100 100 2
550 2150 1 550 2150 1 100 100 100 2
450 2050 1 450 2050 1 100 100 100 2
450 1950 1 450 1950 1 100 100 100 2
350 1850 1 350 1850 1 100 100 100 2
350 1750 1 350 1750 1 100 100 100 2
450 1350 1 450 1350 1 100 100 100 2
250 1450 1 250 1450 1 100 100 100 2
250 1350 1 250 1350 1 100 100 100 2
250 1550 1 250 1550 1 100 100 100 2
550 1750 1 550 1750 1 100 100 100 2
750 1850 1 750 1850 1 100 100 100 2
850 1850 1 850 1850 1 100 100 100 2
950 1850 1 950 1850 1 100 100 100 2
1050 1850 1 1050 1850 1 100 100 100 2
1150 1850 1 1150 1850 1 100 100 100 2
1150 1950 1 1150 1950 1 100 100 100 2
1150 2050 1 1150 2050 1 100 100 100 2
1050 2050 1 1050 2050 1 100 100 100 2
950 2050 1 950 2050 1 100 100 100 2
850 2050 1 850 2050 1 100 100 100 2
750 1750 1 750 1750 1 100 100 100 2
850 1750 1 850 1750 1 100 100 100 2
950 1750 1 950 1750 1 100 100 100 2
1050 1750 1 1050 1750 1 100 100 100 2
1150 1750 1 1150 1750 1 100 100 100 2
1250 1750 1 1250 1750 1 100 100 100 2
1250 1850 1 1250 1850 1 100 100 100 2
1250 1950 1 1250 1950 1 100 100 100 2
550 1650 1 550 1650 1 100 100 100 2
450 1550 1 450 1550 1 100 100 100 2
550 1550 1 550 1550 1 100 100 100 2
550 1450 1 550 1450 1 100 100 100 2
550 1350 1 550 1350 1 100 100 100 2
550 1250 1 550 1250 1 100 100 100 2
450 1450 1 450 1450 1 100 100 100 2
550 1150 1 550 1150 1 100 100 100 2
450 1150 1 450 1150 1 100 100 100 2
450 1250 1 450 1250 1 100 100 100 2
350 1250 1 350 1250 1 100 100 100 2
350 1150 1 350 1150 1 100 100 100 2
350 1050 1 350 1050 1 100 100 100 2
350 950 1 350 950 1 100 100 100 2
350 850 1 350 850 1 100 100 100 2
250 850 1 250 850 1 100 100 100 2
150 850 1 150 850 1 100 100 100 2
150 950 1 150 950 1 100 100 100 2
150 1050 1 150 1050 1 100 100 100 2
150 1150 1 150 1150 1 100 100 100 2
150 1250 1 150 1250 1 100 100 100 2
150 1350 1 150 1350 1 100 100 100 2
150 1450 1 150 1450 1 100 100 100 2
150 1550 1 150 1550 1 100 100 100 2
150 1650 1 150 1650 1 100 100 100 2
150 1750 1 150 1750 1 100 100 100 2
250 1750 1 250 1750 1 100 100 100 2
250 1850 1 250 1850 1 100 100 100 2
250 1950 1 250 1950 1 100 100 100 2
250 2050 1 250 2050 1 100 100 100 2
350 1950 1 350 1950 1 100 100 100 2
250 1650 1 250 1650 1 100 100 100 2
350 2050 1 350 2050 1 100 100 100 2
350 2150 1 350 2150 1 100 100 100 2
450 2150 1 450 2150 1 100 100 100 2
450 2250 1 450 2250 1 100 100 100 2
550 2250 1 550 2250 1 100 100 100 2
650 2150 1 650 2150 1 100 100 100 2
1250 2150 1 1250 2150 1 100 100 100 2
1350 2150 1 1350 2150 1 100 100 100 2
1350 2050 1 1350 2050 1 100 100 100 2
