2500 2500
143
1050 1150 1 1050 1150 1 100 100 100 0
1050 1050 1 1050 1050 1 100 100 100 0
1050 950 1 1050 950 1 100 100 100 0
1050 850 1 1050 850 1 100 100 100 0
1050 750 1 1050 750 1 100 100 100 0
1150 750 1 1150 750 1 100 100 100 0
1150 650 1 1150 650 1 100 100 100 0
1250 650 1 1250 650 1 100 100 100 0
1250 750 1 1250 750 1 100 100 100 0
1350 750 1 1350 750 1 100 100 100 0
1350 850 1 1350 850 1 100 100 100 0
1450 950 1 1450 950 1 100 100 100 0
1450 1050 1 1450 1050 1 100 100 100 0
1450 1150 1 1450 1150 1 100 100 100 0
1450 1250 1 1450 1250 1 100 100 100 0
1450 1350 1 1450 1350 1 100 100 100 0
1350 1450 1 1350 1450 1 100 100 100 0
1250 1550 1 1250 1550 1 100 100 100 0
1150 1550 1 1150 1550 1 100 100 100 0
1050 1550 1 1050 1550 1 100 100 100 0
950 1550 1 950 1550 1 100 100 100 0
950 1450 1 950 1450 1 100 100 100 0
950 1350 1 950 1350 1 100 100 100 0
950 1250 1 950 1250 1 100 100 100 0
1050 1250 1 1050 1250 1 100 100 100 0
1650 1550 1 1650 1550 1 100 100 100 0
1650 1450 1 1650 1450 1 100 100 100 0
1650 1350 1 1650 1350 1 100 100 100 0
1650 1250 1 1650 1250 1 100 100 100 0
1650 1150 1 1650 1150 1 100 100 100 0
1650 1050 1 1650 1050 1 100 100 100 0
1650 950 1 1650 950 1 100 100 100 0
1650 850 1 1650 850 1 100 100 100 0
1650 750 1 1650 750 1 100 100 100 0
1650 650 1 1650 650 1 100 100 100 0
1550 750 1 1550 750 1 100 100 100 0
1850 650 1 1850 650 1 100 100 100 1
1950 650 1 1950 650 1 100 100 100 1
2050 650 1 2050 650 1 100 100 100 1
2050 750 1 2050 750 1 100 100 100 1
2050 850 1 2050 850 1 100 100 100 1
2050 950 1 2050 950 1 100 100 100 1
2050 1050 1 2050 1050 1 100 100 100 1
1950 1050 1 1950 1050 1 100 100 100 1
1850 1050 1 1850 1050 1 100 100 100 1
1850 1150 1 1850 1150 1 100 100 100 1
1850 1250 1 1850 1250 1 100 100 100 1
1850 1350 1 1850 1350 1 100 100 100 1
1950 1350 1 1950 1350 1 100 100 100 1
2050 1350 1 2050 1350 1 100 100 100 1
2250 650 1 2250 650 1 100 100 100 1
2350 650 1 2350 650 1 100 100 100 1
2450 650 1 2450 650 1 100 100 100 1
2450 750 1 2450 750 1 100 100 100 1
2450 850 1 2450 850 1 100 100 100 1
2450 950 1 2450 950 1 100 100 100 1
2350 950 1 2350 950 1 100 100 100 1
2250 950 1 2250 950 1 100 100 100 1
2450 1050 1 2450 1050 1 100 100 100 1
2450 1150 1 2450 1150 1 100 100 100 1
2450 1250 1 2450 1250 1 100 100 100 1
2450 1350 1 2450 1350 1 100 100 100 1
2350 1350 1 2350 1350 1 100 100 100 1
2250 1350 1 2250 1350 1 100 100 100 1
1150 1750 1 1150 1750 1 100 100 100 2
1150 1850 1 1150 1850 1 100 100 100 2
1150 1950 1 1150 1950 1 100 100 100 2
1150 2050 1 1150 2050 1 100 100 100 2
1250 2050 1 1250 2050 1 100 100 100 2
1350 2050 1 1350 2050 1 100 100 100 2
1450 2050 1 1450 2050 1 100 100 100 2
1550 1750 1 1550 1750 1 100 100 100 2
1550 1850 1 1550 1850 1 100 100 100 2
1550 1950 1 1550 1950 1 100 100 100 2
1550 2050 1 1550 2050 1 100 100 100 2
1550 2150 1 1550 2150 1 100 100 100 2
1550 2250 1 1550 2250 1 100 100 100 2
1550 2350 1 1550 2350 1 100 100 100 2
1750 1750 1 1750 1750 1 100 100 100 2
1850 1750 1 1850 1750 1 100 100 100 2
1950 1750 1 1950 1750 1 100 100 100 2
1950 1850 1 1950 1850 1 100 100 100 2
1950 1950 1 1950 1950 1 100 100 100 2
1950 2050 1 1950 2050 1 100 100 100 2
1850 2050 1 1850 2050 1 100 100 100 2
1750 2050 1 1750 2050 1 100 100 100 2
1750 2150 1 1750 2150 1 100 100 100 2
1750 2250 1 1750 2250 1 100 100 100 2
1850 2250 1 1850 2250 1 100 100 100 2
1950 2250 1 1950 2250 1 100 100 100 2
2350 1750 1 2350 1750 1 100 100 100 2
2250 1750 1 2250 1750 1 100 100 100 2
2150 1750 1 2150 1750 1 100 100 100 2
2150 1850 1 2150 1850 1 100 100 100 2
2150 1950 1 2150 1950 1 100 100 100 2
2150 2050 1 2150 2050 1 100 100 100 2
2150 2150 1 2150 2150 1 100 100 100 2
2150 2250 1 2150 2250 1 100 100 100 2
2250 2250 1 2250 2250 1 100 100 100 2
2350 2250 1 2350 2250 1 100 100 100 2
2350 2150 1 2350 2150 1 100 100 100 2
2350 2050 1 2350 2050 1 100 100 100 2
2250 2050 1 2250 2050 1 100 100 100 2
750 2350 1 750 2350 1 100 100 100 2
750 2250 1 750 2250 1 100 100 100 2
750 2150 1 750 2150 1 100 100 100 2
750 2050 1 750 2050 1 100 100 100 2
750 1950 1 750 1950 1 100 100 100 2
750 1850 1 750 1850 1 100 100 100 2
650 2050 1 650 2050 1 100 100 100 2
850 2050 1 850 2050 1 100 100 100 2
750 1750 1 750 1750 1 100 100 100 2
650 1750 1 650 1750 1 100 100 100 2
550 2050 1 550 2050 1 100 100 100 2
550 1750 1 550 1750 1 100 100 100 2
250 1750 1 250 1750 1 100 100 100 2
350 1750 1 350 1750 1 100 100 100 2
350 1850 1 350 1850 1 100 100 100 2
350 2050 1 350 2050 1 100 100 100 2
350 2150 1 350 2150 1 100 100 100 2
350 2250 1 350 2250 1 100 100 100 2
250 2250 1 250 2250 1 100 100 100 2
150 2250 1 150 2250 1 100 100 100 2
150 2150 1 150 2150 1 100 100 100 2
150 2050 1 150 2050 1 100 100 100 2
150 1950 1 150 1950 1 100 100 100 2
150 1850 1 150 1850 1 100 100 100 2
150 1750 1 150 1750 1 100 100 100 2
350 1950 1 350 1950 1 100 100 100 2
250 1950 1 250 1950 1 100 100 100 2
250 2050 1 250 2050 1 100 100 100 2
350 1550 1 350 1550 1 100 100 100 2
350 1450 1 350 1450 1 100 100 100 2
350 1350 1 350 1350 1 100 100 100 2
350 1250 1 350 1250 1 100 100 100 2
350 1150 1 350 1150 1 100 100 100 2
350 1050 1 350 1050 1 100 100 100 2
250 1050 1 250 1050 1 100 100 100 2
150 1050 1 150 1050 1 100 100 100 2
150 1150 1 150 1150 1 100 100 100 2
150 1250 1 150 1250 1 100 100 100 2
150 1350 1 150 1350 1 100 100 100 2
250 1350 1 250 1350 1 100 100 100 2
